XXXXXXXXXXXXXXXXXXXXXXXXXXXXXXXXXXXXXXXXXXXXXXXXXXXXX
XXXXX00000000000000000000000000000000000000000000000X
X000000000000000000000000000000000000000000000000000X
X000000000000000000000000000000000000000000000000000X
X000000000000000000000000000000000000000000000000000X
X000000000000000000000000000000000000000000000000000X
X000000000000000000000000000000000000000000000000000X
X000000000000000000000000000000000000000000000000000X
X000000000000000000000000000000000000000000000000000X
X000000000000000000000000000000000000000000000000000X
X000000000000000000000000000000000000000000000000000X
X000000000000000000000000000000000000000000000000000X
XXXXXXXXXXXXXXXXXXXXXXXXXXXXXXXXXXXXXXXXXXXXXXXXXXXXX